"aa" = (/turf/closed/indestructible/rock,/area/barony/edge)
"ab" = (/turf/open/space/basic,/area/space)
"ac" = (/obj/structure/table/wood,/obj/item/reagent_containers/glass/beaker/mortar,/obj/item/pestle,/turf/open/floor/wood,/area/barony/inside)
"ad" = (/turf/closed/wall/mineral/wood/nonmetal,/area/barony/inside)
"ae" = (/obj/structure/table/wood,/obj/item/reagent_containers/glass/beaker/mug,/obj/item/reagent_containers/glass/beaker/mug,/obj/item/reagent_containers/glass/beaker/mug,/obj/item/reagent_containers/glass/beaker/mug,/turf/open/floor/wood,/area/barony/inside)
"af" = (/turf/open/floor/wood,/area/barony/inside)
"ag" = (/obj/structure/table/wood,/turf/open/floor/wood,/area/barony/inside)
"ah" = (/obj/structure/chair/wood/normal{dir = 8},/turf/open/floor/wood,/area/barony/inside)
"ai" = (/obj/structure/chair/wood/normal,/turf/open/floor/wood,/area/barony/inside)
"aj" = (/obj/structure/closet/crate/wooden,/turf/open/floor/wood,/area/barony/inside)
"ak" = (/obj/structure/chair/wood/normal{dir = 4},/turf/open/floor/wood,/area/barony/inside)
"al" = (/obj/structure/mineral_door/wood,/turf/open/floor/wood,/area/barony/inside)
"am" = (/obj/effect/light_emitter/sun_light,/turf/open/floor/grass,/area/barony/outside)
"an" = (/obj/structure/table/wood,/obj/item/twohanded/fireaxe/fellingaxe,/turf/open/floor/wood,/area/barony/inside)
"ao" = (/obj/structure/table/wood,/obj/item/flashlight/lantern{on = 1},/turf/open/floor/wood,/area/barony/inside)
"ap" = (/turf/open/floor/carpet,/area/barony/inside)
"aq" = (/obj/item/flashlight/lantern{on = 1},/obj/structure/table/wood,/turf/open/floor/wood,/area/barony/inside)
"ar" = (/obj/structure/chair/wood/normal{dir = 1},/turf/open/floor/wood,/area/barony/inside)
"as" = (/obj/effect/landmark/observer_start,/obj/effect/landmark/latejoin,/turf/open/floor/wood,/area/barony/inside)
"at" = (/obj/structure/table/wood,/obj/item/reagent_containers/glass/rag,/obj/item/reagent_containers/glass/rag,/turf/open/floor/wood,/area/barony/inside)
"au" = (/obj/effect/landmark/start/knight,/turf/open/floor/grass,/area/barony/outside)
"av" = (/turf/open/floor/grass,/area/barony/outside)
"aw" = (/obj/effect/landmark/start/peasant,/turf/open/floor/grass,/area/barony/outside)
"ax" = (/obj/structure/flora/bush,/turf/open/floor/grass,/area/barony/outside)
"ay" = (/obj/structure/flora/rock,/turf/open/floor/grass,/area/barony/outside)
"az" = (/obj/structure/flora/ausbushes,/turf/open/floor/grass,/area/barony/outside)
"aA" = (/obj/structure/flora/tree/jungle/small,/turf/open/floor/grass,/area/barony/outside)
"aB" = (/obj/structure/flora/tree/jungle,/turf/open/floor/grass,/area/barony/outside)
"aC" = (/obj/structure/fermenting_barrel,/turf/open/floor/wood,/area/barony/inside)
"aD" = (/obj/structure/bed/medieval,/turf/open/floor/wood,/area/barony/inside)
"aE" = (/obj/structure/flora/ausbushes,/obj/effect/light_emitter/sun_light,/turf/open/floor/grass,/area/barony/outside)
"aF" = (/obj/machinery/hydroponics/soil/medieval,/turf/open/floor/grass,/area/barony/outside)
"aG" = (/obj/item/flashlight/lantern{on = 1},/turf/open/floor/wood,/area/barony/inside)
"aH" = (/mob/living/simple_animal/cow,/turf/open/floor/wood,/area/barony/inside)
"aI" = (/mob/living/simple_animal/chicken,/turf/open/floor/wood,/area/barony/inside)
"aJ" = (/obj/item/flashlight/lantern{on = 1},/mob/living/simple_animal/chicken,/turf/open/floor/wood,/area/barony/inside)
"aK" = (/obj/structure/table/wood,/obj/item/reagent_containers/glass/bucket,/obj/item/reagent_containers/glass/bucket,/turf/open/floor/wood,/area/barony/inside)
"aL" = (/obj/structure/table/wood,/obj/item/clothing/head/rice_hat,/obj/item/clothing/head/rice_hat,/turf/open/floor/wood,/area/barony/inside)
"aM" = (/obj/structure/table/wood,/obj/item/seeds/wheat,/obj/item/seeds/wheat,/obj/item/seeds/wheat,/obj/item/seeds/wheat,/obj/item/seeds/wheat,/turf/open/floor/wood,/area/barony/inside)
"aN" = (/obj/structure/sink/puddle,/turf/open/floor/grass,/area/barony/outside)
"aO" = (/turf/closed/wall/mineral/wood/nonmetal,/area/barony/armory)
"aP" = (/obj/structure/mineral_door/wood/armory,/turf/open/floor/wood,/area/barony/armory)
"aQ" = (/obj/structure/table/wood,/obj/item/twohanded/steelspear{pixel_x = -10},/obj/item/twohanded/steelspear{pixel_x = 5},/obj/item/twohanded/steelspear{pixel_x = -2},/turf/open/floor/wood,/area/barony/armory)
"aR" = (/turf/open/floor/wood,/area/barony/armory)
"aS" = (/obj/structure/table/wood,/obj/item/bow,/obj/item/storage/backpack/quiver/full,/turf/open/floor/wood,/area/barony/armory)
"aT" = (/obj/structure/table/wood,/obj/item/twohanded/steelspear{pixel_x = -2},/obj/item/twohanded/steelspear{pixel_x = 5},/obj/item/twohanded/steelspear{pixel_x = -10},/turf/open/floor/wood,/area/barony/armory)
"aU" = (/obj/structure/flora/ausbushes/sparsegrass,/turf/open/floor/grass,/area/barony/outside)
"aV" = (/obj/structure/flora/ausbushes/pointybush,/turf/open/floor/grass,/area/barony/outside)
"aW" = (/obj/structure/flora/rock/jungle,/turf/open/floor/grass,/area/barony/outside)
"aX" = (/obj/structure/table/wood,/obj/item/flashlight/lantern{on = 1; pixel_x = -10},/obj/item/clothing/suit/armor/coat_of_plates{pixel_x = 5},/turf/open/floor/wood,/area/barony/armory)
"aY" = (/obj/structure/table/wood,/obj/item/clothing/under/gambeson{pixel_x = -8},/obj/item/clothing/under/gambeson{pixel_x = 8},/turf/open/floor/wood,/area/barony/armory)
"aZ" = (/obj/structure/table/wood,/obj/item/flashlight/lantern{on = 1; pixel_x = 10},/obj/item/clothing/suit/armor/coat_of_plates{pixel_x = -5},/turf/open/floor/wood,/area/barony/armory)
"ba" = (/obj/structure/flora/tree/dead,/turf/open/floor/grass,/area/barony/outside)
"bb" = (/obj/structure/medieval/oven,/turf/open/floor/wood,/area/barony/inside)
"bc" = (/obj/structure/table/wood,/obj/item/clothing/head/chefhat,/turf/open/floor/wood,/area/barony/inside)

(1,1,1) = {"
ababababababababaaaaaaaaaaaaaaaaaaaaaaaaaaaaaaaaaaaaaaaaaaaaaaaaaaaaaaaaaaaaaaaa
ababababababababaaavavavavavavavavavavavavavavavavavavavavavavavavavavavavavavaa
ababababababababaaavavavavavavavavavavavavavavavavavavamamamamamamamamamamavavaa
ababababababababaaavavavavaAavavavaFaFaFaFaFaFaFavavamadadadadadadadadadadamavaa
ababababababababaaavavavavavavavavavavavavavavavavavamadaGafaHaHafafafaGadamavaa
ababababababababaaavavavavavavavavaFaFaFaFaFaFaFavavamadafaHafafafafafafadamavaa
ababababababababaaavavavavavavavavavavavavavavavavavamadafafaHafafaIafaIadamavaa
ababababababababaaavaBavavavavaNavaFaFaFaFaFaFaFavavamadafaHafafafafaIafadamavaa
ababababababababaaavavavavavavavavavavavavavavavavavamadafafafafafafafafadamavaa
ababababababababaaavavavavbaavavavaFaFaFaFaFaFaFavavamadafafafafafafaIaIadamavaa
ababababababababaaavavavavavavavavavavavavavavavavavamadafafafafafafaIafadamavaa
ababababababababaaavavavavavavavavamamamamavavavavavamadaGafafafafafafaJadamavaa
ababababababababaaavavavavavavavamadafafadamamamamavamadadadadalaladadadadamavaa
ababababababababaaavaAavavavavavamadafafadadadafafamavamamamamamamamamamamavavaa
ababababababababaaavavavavavaBavamadafafaKaKafafafamavavavavavavavavavavavavavaa
ababababababababaaavavavavavavavamadaLafafafafafadamavavavavaUavavavavavavavavaa
ababababababababaaavavavavavavavamadaoaMaCaCagaoadamavaVavavavavavavavaWavavavaa
ababababababababaaavavavbaavavavamadadadadadadadadamavavavavavavavavavavavavavaa
ababababababababaaavavavavavavavavamamamamamamamamavavavavavavavavavavavavavavaa
ababababababababaaavaAavavavavavavavavavavavavavavavavavavavavavaUavavavavavavaa
ababababababababaaavavavavavavavavavavavavavavavavavavavavavavavavavavavavavavaa
ababababababababaaavavavavavbaavavavavavavavavavaxavavavavavavavavavavavavavauaa
ababababababababaaavavavavavavavavavavavavavavavavavavavavavavavavavavavavavavaa
ababababababababaaavavavavavavavavayazavavavavavavavavaAavavavavavamamaEamamavaa
ababababababababaaavaBavavavavavaxavavavavavavavavavavavavavavavamadadadadadamaa
ababababababababaaavavavamamamamamamamamamamamamamamamavavavavavamadakaoahadamaa
ababababababababaaavavamadadadadadadadadadadadadadadadamavavavavamadafafafadamaa
ababababababababaaavavamadajbbbbbbadaeafafafafafaiafadamavavavavamalafafafadamaa
ababababababababaaaUavamalafafafafadaeafagahafakagahadamavavavavamadafafafadamaa
ababababababababaaavavamadafbcatafalafafagahafakaoahadamavavavavamadaDagaDadamaa
ababababababababaaavavamadafaoacafadafafagahapapapapalamavavavavamadadadadadamaa
ababababababababaaavavamadafananafadagagaqahapapapapalamavavavavavamamamamamavaa
ababababababababaaavaxamadafafafafadararafafafafafafadamavavavavavavavavavaxavaa
ababababababababaaavavamadagagagaoadafafafafasafafaiadamavavavavavavavazavavavaa
ababababababababaaavavamadadadadadadakaoahakagahakaoadamavavavaUavavavavavavavaa
ababababababababaaavavavamamamamamadadadadadadadadadadamavavavavavavavavavavavaa
ababababababababaaavavavavayavavavamamamamamamamamamamavavavavavavavavavavavavaa
ababababababababaaavavavavavavavavavavavavavavavavavavavavavavavayavavavavavavaa
ababababababababaaavavavavavavavavavavavavamamamamamavavavavavamamamamamamavavaa
ababababababababaaavavavavavavavavavavavamaOaOaPaOaOamavavavamadadadadaladamavaa
ababababababababaaavbaavavavavavavavavavamaOaQaRaSaOamavavavamadaoafafafadamavaa
ababababababababaaavavavavavavavavavavavamaOaTaRaSaOamaxavavamadafaDadaradamavaa
ababababababababaaavavavavavavavavaBavavamaOaXaYaZaOamavavavamadadadadadadamavaa
ababababababababaaavavavavavavavavavavavaEaOaOaOaOaOamavavavavamamamamamamavavaa
ababababababababaaavavavavavavavavavavavavamamamamamavavavavavavavavavavavavawaa
ababababababababaaaaaaaaaaaaaaaaaaaaaaaaaaaaaaaaaaaaaaaaaaaaaaaaaaaaaaaaaaaaaaaa
abababababababababababababababababababababababababababababababababababababababab
abababababababababababababababababababababababababababababababababababababababab
abababababababababababababababababababababababababababababababababababababababab
abababababababababababababababababababababababababababababababababababababababab
"}
